{
  "size": 10,
  "blocklist": [
    5, 5, 1, 5, 2, 5, 5, 1, 6, 5,
    5, 2, 5, 7, 1, 5, 5, 2, 5, 5,
    1, 5, 5, 2, 5, 6, 5, 1, 5, 2,
    5, 5, 1, 5, 5, 2, 5, 5, 5, 1,
    5, 2, 5, 5, 1, 5, 7, 5, 2, 5,
    1, 5, 5, 5, 5, 5, 5, 6, 1, 5,
    5, 2, 5, 9, 5, 1, 5, 2, 5, 5,
    1, 5, 5, 2, 5, 5, 5, 1, 5, 2,
    5, 5, 1, 5, 5, 2, 5, 4, 5, 11,
    1, 2, 3, 4, 6, 5, 7, 8, 9, 0
  ],
  "spawnx": 5,
  "spawny": 5
}
