{
  "size": 10,
  "blocklist": [
    5, 5, 1, 5, 2, 5, 5, 1, 5, 5,
    5, 2, 5, 6, 1, 5, 5, 2, 7, 5,
    1, 5, 5, 2, 5, 5, 5, 1, 5, 2,
    5, 5, 1, 5, 5, 2, 6, 5, 5, 1,
    5, 2, 5, 5, 1, 7, 5, 5, 2, 5,
    1, 5, 5, 5, 5, 5, 5, 5, 1, 5,
    5, 2, 5, 5, 5, 1, 6, 2, 5, 5,
    1, 5, 5, 2, 5, 5, 7, 1, 5, 2,
    5, 10, 1, 5, 5, 2, 5, 4, 5, 1,
    1, 2, 3, 4, 6, 5, 7, 8, 9, 0
  ],
  "spawnx": 5,
  "spawny": 5
}
